1111111111111111111111111111111111111111111111
10010C00000C110010000000000C000000000000000001
1000011111001100001001111111000000000111000111
1001100000110000111001111111000000001111100011
10000001100000111111001111000C00000001C0110011
100P000110000C11111110C00000000000000000111E11
1111111111111111111111111111111111111111111111