1111111111111
1001000000001
10P0011100001
10C011E000001
1111111111111